~~~~~~~~~~~~~~~~#~~~~~~~~
~~~#~~~#~~~~~~~~~~~~~~~~~
~~~~~~~~~~~~#~~~~~~~#~~~#
~~~~~~~~~~~~~~~~~~~~~~~~~
~~~~~~~~~~#~~~~~~~~~~~~~~
~~~~~~~#~~#~#~#~~~~~~~~~~
~~~~~~##~~~~~~~~~#~~##~~~
#~~~#~~~~~~~~~~~~~~~~#~~~
~~~~~~~~~~~~~~~~~~~~~~~~#
~~~~~~~~~~~~#~~~#~~~~~~~~
~~#~~#~~~~~~~~#~~~~~#~~~~
~~~~~#~~~~~~~~~~~~~~~~~#~
~~~~~~~~~~~~~~~~~~~~~~~~~
~~~~~~~#~#~~~#~~~~~~~~~~~
~~~~~~~~~~#~~~~#~~~~~~#~~
~~~~~~~~#~~~~~~~~#~~~~~~~
~~~~~~~#~~~~~~~~~~~~~~~~~
~~~~~#~~~~~~~~~~~~~~~#~#~
~~~~~~~~~~~~~~~~~~~~#~#~~
~~~~~##~~~~~~~~~~~~~~~~~~
~~~~#~~~~~~#~~~~~~~~~~~~~
~~~~~~~~~#~~~~~~~~#~~~#~~
~~~~~~~~~~~~~#~~~~~~~#~~~
~~~#~~~~~~~#~~~~~~~~~~~~~
~~~~~~~~#~~~~~~~~~~~~#~~~
